11111
1i101
10101
10001
11111